###################################
#.................................#
#.................................#
#..P..~...........................#
#.................................#
#.........##############..........#
#..................#...#.......!..#
#..~...............#...#..........#
#...................#..#..........#
#....................###..........#
#..........................!...B..#
#.................................#
#.................................#
###################################
