#########################
#.......................#
#...~...................#
#.......................#
#.P..~.........!...B....#
#.......................#
#...~...................#
#.......................#
#########################
