####################################################################
#...............................#..................................#
#...............................#..................................#
#........~......................#.........................!........#
#..................................................................#
#..................................................................#
#............#........................................#............#
#...P....~...#........................................#...!....B...#
#............#........................................#............#
#..................................................................#
#..................................................................#
#........~......................#.........................!........#
#...............................#..................................#
#...............................#..................................#
####################################################################