######################
#....................#
#.........##.........#
#.........##.........#
#.P.......##.......B.#
#.........##.........#
#....................#
#....................#
######################
