######################
#....................#
#...~............!...#
#....................#
#.P..~..........!..B.#
#....................#
#...~............!...#
#....................#
######################
