######################
#....................#
#...~................#
#....................#
#.P..~..!.........B..#
#....................#
#...~................#
#....................#
######################
