######################
#....................#
#...~................#
#....................#
#.P..~.............B.#
#....................#
#...~................#
#....................#
######################
