######################
#.........#..........#
#...~.....#..........#
#.........#..........#
#..P...~..#...!...B..#
#.........#..........#
#...~.....#..........#
#.........#..........#
#.........#..........#
#....................#
#....................#
#....................#
#....................#
######################
