######################
#....................#
#....~....##....~....#
#.........##.........#
#.P..~....##....~..B.#
#....~....##....~....#
#....................#
#....................#
######################
