######################
#....................#
#...~................#
#....................#
#.P..~.........!...B.#
#....................#
#...~................#
#....................#
######################
