######################
#....................#
#...~................#
#....................#
#..P...~......!...B..#
#....................#
#...~................#
#....................#
#....................#
#....................#
#....................#
#....................#
#....................#
######################
